Solving...
Local Greedy solution was found opening: 264 nodes
When using the Manhattan Distance heuristic
Frontier nodes: 94
#######
#P  O #
#OOB  #
#B BB #
#   O #
#######
Depth:  38
#######
# P O #
#OOB  #
#B BB #
#   O #
#######
#######
#   O #
#OxB  #
#B BB #
#   O #
#######
#######
#   O #
#OOPB #
#B BB #
#   O #
#######
#######
#   O #
#OO B #
#B PB #
#  BO #
#######
#######
#   O #
#OO B #
#BP B #
#  BO #
#######
#######
#   O #
#OO B #
#B  B #
# PBO #
#######
#######
#   O #
#OO B #
#B  B #
#  P* #
#######
#######
#   O #
#OO B #
#B PB #
#   * #
#######
#######
#   O #
#OOPB #
#B  B #
#   * #
#######
#######
#   O #
#Ox B #
#B  B #
#   * #
#######
#######
# P O #
#OO B #
#B  B #
#   * #
#######
#######
#  PO #
#OO B #
#B  B #
#   * #
#######
#######
#   x #
#OO B #
#B  B #
#   * #
#######
#######
#   OP#
#OO B #
#B  B #
#   * #
#######
#######
#   O #
#OO BP#
#B  B #
#   * #
#######
#######
#   O #
#OOBP #
#B  B #
#   * #
#######
#######
#   O #
#O*P  #
#B  B #
#   * #
#######
#######
#   O #
#O*   #
#B PB #
#   * #
#######
#######
#   O #
#O*   #
#BP B #
#   * #
#######
#######
#   O #
#O*   #
#B  B #
# P * #
#######
#######
#   O #
#O*   #
#B  B #
#P  * #
#######
#######
#   O #
#**   #
#P  B #
#   * #
#######
#######
#   O #
#**   #
# P B #
#   * #
#######
#######
#   O #
#**   #
#  PB #
#   * #
#######
#######
#   O #
#**P  #
#   B #
#   * #
#######
#######
#   O #
#** P #
#   B #
#   * #
#######
#######
#   O #
#**  P#
#   B #
#   * #
#######
#######
#   O #
#**   #
#   BP#
#   * #
#######
#######
#   O #
#**   #
#   B #
#   *P#
#######
#######
#   O #
#**   #
#   B #
#  Bx #
#######
#######
#   O #
#** B #
#   P #
#  BO #
#######
#######
#   * #
#** P #
#     #
#  BO #
#######
#######
#   * #
#**P  #
#     #
#  BO #
#######
#######
#   * #
#**   #
#  P  #
#  BO #
#######
#######
#   * #
#**   #
# P   #
#  BO #
#######
#######
#   * #
#**   #
#     #
# PBO #
#######
#######
#   * #
#**   #
#     #
#  P* #
#######

It took 0.002994061 seconds to solve the map: map5.txt


Local Greedy solution was found opening: 105 nodes
When using the Improved Modified Manhattan heuristic
Frontier nodes: 49
#######
#P  O #
#OOB  #
#B BB #
#   O #
#######
Depth:  26
#######
# P O #
#OOB  #
#B BB #
#   O #
#######
#######
#   O #
#OxB  #
#B BB #
#   O #
#######
#######
#   O #
#OOPB #
#B BB #
#   O #
#######
#######
#   O #
#Ox B #
#B BB #
#   O #
#######
#######
#   O #
#OO B #
#BPBB #
#   O #
#######
#######
#   O #
#OO B #
#B BB #
# P O #
#######
#######
#   O #
#OO B #
#B BB #
#  PO #
#######
#######
#   O #
#OOBB #
#B PB #
#   O #
#######
#######
#   O #
#OOBB #
#B  B #
#  PO #
#######
#######
#   O #
#OOBB #
#B  B #
# P O #
#######
#######
#   O #
#OOBB #
#B  B #
#P  O #
#######
#######
#   O #
#*OBB #
#P  B #
#   O #
#######
#######
#   O #
#*OBB #
# P B #
#   O #
#######
#######
#   O #
#*OBB #
#   B #
# P O #
#######
#######
#   O #
#*OBB #
#   B #
#  PO #
#######
#######
#   O #
#*OBB #
#   B #
#   x #
#######
#######
#   O #
#*OBB #
#   B #
#   OP#
#######
#######
#   O #
#*OBB #
#   BP#
#   O #
#######
#######
#   O #
#*OBB #
#  BP #
#   O #
#######
#######
#   * #
#*OBP #
#  B  #
#   O #
#######
#######
#   * #
#**P  #
#  B  #
#   O #
#######
#######
#   * #
#**   #
#  P  #
#  BO #
#######
#######
#   * #
#**   #
# P   #
#  BO #
#######
#######
#   * #
#**   #
#     #
# PBO #
#######
#######
#   * #
#**   #
#     #
#  P* #
#######

It took 0.005522966 seconds to solve the map: map5.txt
