Solving...
DFS solution was found opening: 3308 nodes
Frontier nodes: 43
########
#P#    #
# O B  #
#   B  #
#  O   #
########
Depth:  31
########
# #    #
#PO B  #
#   B  #
#  O   #
########
########
# #    #
# O B  #
#P  B  #
#  O   #
########
########
# #    #
# O B  #
#   B  #
#P O   #
########
########
# #    #
# O B  #
#   B  #
# PO   #
########
########
# #    #
# O B  #
#   B  #
#  x   #
########
########
# #    #
# O B  #
#   B  #
#  OP  #
########
########
# #    #
# O B  #
#   B  #
#  O P #
########
########
# #    #
# O B  #
#   B  #
#  O  P#
########
########
# #    #
# O B  #
#   B P#
#  O   #
########
########
# #    #
# O B  #
#   BP #
#  O   #
########
########
# #    #
# O B  #
#  BP  #
#  O   #
########
########
# #    #
# O B  #
# BP   #
#  O   #
########
########
# #    #
# O B  #
# B    #
#  x   #
########
########
# #    #
# O B  #
# B    #
# PO   #
########
########
# #    #
# O B  #
# B    #
#P O   #
########
########
# #    #
# O B  #
#PB    #
#  O   #
########
########
# #    #
# O B  #
# PB   #
#  O   #
########
########
# #    #
# O B  #
#P B   #
#  O   #
########
########
# #    #
# O B  #
#  B   #
#P O   #
########
########
# #    #
# O B  #
#  B   #
# PO   #
########
########
# #    #
# O B  #
#  B   #
#  x   #
########
########
# #    #
# O B  #
#  B   #
#  OP  #
########
########
# #    #
# O B  #
#  B   #
#  O P #
########
########
# #    #
# O B  #
#  B   #
#  O  P#
########
########
# #    #
# O B  #
#  B  P#
#  O   #
########
########
# #    #
# O B  #
#  B P #
#  O   #
########
########
# #    #
# O BP #
#  B   #
#  O   #
########
########
# #    #
# OBP  #
#  B   #
#  O   #
########
########
# #    #
# *P   #
#  B   #
#  O   #
########
########
# #    #
# *    #
#  P   #
#  *   #
########



It took 0.016379833 seconds to solve the map: map1.txt
