Solving...
Local Greedy solution was found opening: 717 nodes
When using the Manhattan Distance heuristic
Frontier nodes: 227
#######
#P    #
#  OB #
# OBB #
#    O#
#######
Depth:  41
#######
#     #
#P OB #
# OBB #
#    O#
#######
#######
#     #
#  OB #
#POBB #
#    O#
#######
#######
#     #
#  OB #
# OBB #
#P   O#
#######
#######
#     #
#  OB #
# OBB #
# P  O#
#######
#######
#     #
#  OB #
# OBB #
#  P O#
#######
#######
#     #
#  *B #
# OPB #
#    O#
#######
#######
#     #
#  *B #
# O PB#
#    O#
#######
#######
#     #
#  *B #
# OP B#
#    O#
#######
#######
#     #
#  *B #
# x  B#
#    O#
#######
#######
#     #
# P*B #
# O  B#
#    O#
#######
#######
# P   #
#  *B #
# O  B#
#    O#
#######
#######
#  P  #
#  *B #
# O  B#
#    O#
#######
#######
#   P #
#  *B #
# O  B#
#    O#
#######
#######
#    P#
#  *B #
# O  B#
#    O#
#######
#######
#     #
#  *BP#
# O  B#
#    O#
#######
#######
#     #
#  *B #
# O  P#
#    *#
#######
#######
#     #
#  *B #
# O P #
#    *#
#######
#######
#     #
#  *B #
# OP  #
#    *#
#######
#######
#     #
#  *B #
# x   #
#    *#
#######
#######
#     #
#  *B #
#PO   #
#    *#
#######
#######
#     #
#P *B #
# O   #
#    *#
#######
#######
#     #
# P*B #
# O   #
#    *#
#######
#######
# P   #
#  *B #
# O   #
#    *#
#######
#######
#  P  #
#  *B #
# O   #
#    *#
#######
#######
#     #
#  xB #
# OB  #
#    *#
#######
#######
#     #
# POB #
# OB  #
#    *#
#######
#######
#     #
#P OB #
# OB  #
#    *#
#######
#######
#     #
#  OB #
#POB  #
#    *#
#######
#######
#     #
#  OB #
# xB  #
#    *#
#######
#######
#     #
#  OB #
# OB  #
# P  *#
#######
#######
#     #
#  OB #
# OB  #
#  P *#
#######
#######
#     #
#  OB #
# OB  #
#   P*#
#######
#######
#     #
#  OB #
# OBP #
#    *#
#######
#######
#     #
#  OB #
# *P  #
#    *#
#######
#######
#     #
#  xB #
# *   #
#    *#
#######
#######
#  P  #
#  OB #
# *   #
#    *#
#######
#######
#   P #
#  OB #
# *   #
#    *#
#######
#######
#    P#
#  OB #
# *   #
#    *#
#######
#######
#     #
#  OBP#
# *   #
#    *#
#######
#######
#     #
#  *P #
# *   #
#    *#
#######



It took 0.006083965 seconds to solve the map: map4.txt


Local Greedy solution was found opening: 43 nodes
When using the Improved Modified Manhattan heuristic
Frontier nodes: 20
#######
#P    #
#  OB #
# OBB #
#    O#
#######
Depth:  15
#######
#     #
#P OB #
# OBB #
#    O#
#######
#######
#     #
#  OB #
#POBB #
#    O#
#######
#######
#     #
#  OB #
# OBB #
#P   O#
#######
#######
#     #
#  OB #
# OBB #
# P  O#
#######
#######
#     #
#  OB #
# OBB #
#  P O#
#######
#######
#     #
#  OB #
# OBB #
#   PO#
#######
#######
#     #
#  OB #
# OBB #
#    x#
#######
#######
#     #
#  OB #
# OBBP#
#    O#
#######
#######
#     #
#  OBP#
# OBB #
#    O#
#######
#######
#     #
#  *P #
# OBB #
#    O#
#######
#######
#     #
#  *  #
# OBP #
#   BO#
#######
#######
#     #
#  *  #
# *P  #
#   BO#
#######
#######
#     #
#  *  #
# *   #
#  PBO#
#######
#######
#     #
#  *  #
# *   #
#   P*#
#######



It took 0.001032114 seconds to solve the map: map4.txt


