
#######
#     #
#POB  #
#  B  #
#O    #
#######
