#######
#P #  #
#O B O#
#  B  #
# #   #
#######
