
#######
#P    #
#  OB #
# OBB #
#    O#
#######
