
#######
#P  O #
#OOB  #
#B BB #
#   O #
#######
