Solving...
DFS solution was found opening: 621 nodes
Frontier nodes: 77
#######
#     #
#POB  #
#  B  #
#O    #
#######
Depth:  56
#######
#     #
# OB  #
#P B  #
#O    #
#######
#######
#     #
# OB  #
#  B  #
#x    #
#######
#######
#     #
# OB  #
#  B  #
#OP   #
#######
#######
#     #
# OB  #
#  B  #
#O P  #
#######
#######
#     #
# OB  #
#  B  #
#O  P #
#######
#######
#     #
# OB  #
#  B  #
#O   P#
#######
#######
#     #
# OB  #
#  B P#
#O    #
#######
#######
#     #
# OB  #
#  BP #
#O    #
#######
#######
#     #
# OB  #
# BP  #
#O    #
#######
#######
#     #
# OB  #
#BP   #
#O    #
#######
#######
#     #
# OB  #
#B    #
#OP   #
#######
#######
#     #
# OB  #
#B    #
#x    #
#######
#######
#     #
#BOB  #
#P    #
#O    #
#######
#######
#     #
#BOB  #
#     #
#x    #
#######
#######
#     #
#BOB  #
#     #
#OP   #
#######
#######
#     #
#BOB  #
#     #
#O P  #
#######
#######
#     #
#BOB  #
#     #
#O  P #
#######
#######
#     #
#BOB  #
#     #
#O   P#
#######
#######
#     #
#BOB  #
#    P#
#O    #
#######
#######
#     #
#BOB  #
#   P #
#O    #
#######
#######
#     #
#BOB  #
#  P  #
#O    #
#######
#######
#     #
#BOB  #
# P   #
#O    #
#######
#######
#     #
#BxB  #
#     #
#O    #
#######
#######
#     #
#BOPB #
#     #
#O    #
#######
#######
#     #
#Bx B #
#     #
#O    #
#######
#######
#     #
#BO B #
# P   #
#O    #
#######
#######
#     #
#BO B #
#P    #
#O    #
#######
#######
#     #
#BO B #
#     #
#x    #
#######
#######
#     #
#BO B #
#     #
#OP   #
#######
#######
#     #
#BO B #
#     #
#O P  #
#######
#######
#     #
#BO B #
#     #
#O  P #
#######
#######
#     #
#BO B #
#     #
#O   P#
#######
#######
#     #
#BO B #
#    P#
#O    #
#######
#######
#     #
#BO BP#
#     #
#O    #
#######
#######
#     #
#BOBP #
#     #
#O    #
#######
#######
#     #
#B*P  #
#     #
#O    #
#######
#######
#     #
#B*   #
#  P  #
#O    #
#######
#######
#     #
#B*   #
# P   #
#O    #
#######
#######
#     #
#B*   #
#P    #
#O    #
#######
#######
#     #
#B*   #
#     #
#x    #
#######
#######
#     #
#B*   #
#     #
#OP   #
#######
#######
#     #
#B*   #
#     #
#O P  #
#######
#######
#     #
#B*   #
#     #
#O  P #
#######
#######
#     #
#B*   #
#     #
#O   P#
#######
#######
#     #
#B*   #
#    P#
#O    #
#######
#######
#     #
#B*   #
#   P #
#O    #
#######
#######
#     #
#B* P #
#     #
#O    #
#######
#######
#     #
#B*  P#
#     #
#O    #
#######
#######
#    P#
#B*   #
#     #
#O    #
#######
#######
#   P #
#B*   #
#     #
#O    #
#######
#######
#  P  #
#B*   #
#     #
#O    #
#######
#######
# P   #
#B*   #
#     #
#O    #
#######
#######
#P    #
#B*   #
#     #
#O    #
#######
#######
#     #
#P*   #
#B    #
#O    #
#######
#######
#     #
# *   #
#P    #
#*    #
#######



It took 0.0026021 seconds to solve the map: map2.txt
